NO ./textures/red.xpm
SO ./textures/bluestone.xpm
EA ./textures/greystone.xpm
WE ./textures/red.xpm

F 200,             255,255
C 238  ,175,97

11111111111111111
10011100001011111
10001100000011111
10000000000000111
10000000001000001
11110000000N00001
11110000000000001
10000001000110001
1111111 111 1111111