NO ./textures/red.xpm
SO ./textures/bluestone.xpm
EA ./textures/greystone.xpm
WE ./textures/red.xpm

F 220,100,20
C 225,30,0

		11111111 1111111111111   111
100000000     01000000000001
101100000110000001    000001
10010000000000    0000000001
1111111		11011000001100000000001
1000000000110000011011111111
1111011111111101110000010000
1111011111111101111010010001        
1100000011010101110000010001
100010E000000000110000010001
1000000000000000111010010001
1100000111010101111011110101
11110111 1110101 11111010001
11111111 1111111111111111111
