NO ./textures/Background.xpm
SO ./textures/bluestone.xpm
EA ./textures/greystone.xpm
WE ./textures/red.xpm
F 220,100,0
C 225,30,0

11111111111111111111111111111111111111111
10010101010100000001111000110101010000001
10100100000111000111110000110101010000001
1100N100000111111000011100110101010000001
10010101010100000001111000110101010000001
10100100000111000111110000110101010000001
10010101010100000001111000110101010000001
10100100000111000111110000110101010000001
10010101010100000001111000110101010000001
10100100000111000111110000110101010000001
10010101010100000001111000110101010000001
10100100000111000111110000110101010000001
10010101010100000001111000110101010000001
10100100000111000111110000110101010000001
10010101010100000001111000110101010000001
10100100000111000111110000110101010000001
10010101010100000001111000110101010000001
10100100000111000111110000110101010000001
10010101010100000001111000110101010000001
10100100000111000111110000110101010000001
11111111111111111111111111111111111111111