NO ./textures/red.xpm
SO ./textures/bluestone.xpm
EA ./textures/greystone.xpm
WE ./textures/red.xpm

F 220,100,0
C 225,30,0
        111111111111111111111111
        100000000010000000000001
        101100000110000001000001
        100100000000000000000001
11111111101100000110000000000001
10000000001100000110111111111111
1111011111111101110000010001
1111011111111101111010010001
1100000011010101110000010001
1000100000000000110000010001
1000000000000000111010010001
1100000111010101111011110N0111
11110111 1110101 11111010001
11111111 1111111 11111111111