NO ./textures/Background.xpm
SO ./textures/bluestone.xpm
EA ./textures/greystone.xpm
WE ./textures/red.xpm

F 220,100,0
C 225,30,0

1111111111111111111111111111111111111111111111111111111
1000000000000000000000000001000000000010000000000000001
1011111111111110111111111101011111111110111111111111101
1010000000000000000000000001000000000000000000000000101
1010111111111110101111110111111111111111111111111110101
1010100000000000100000000001000000000000000000000010101
1010101011101110101011110101111110101010111110101010101
1010101000101000100000000100000000100010000010101010101
1000100000001010100000000000000000000010100000001000001
1E00111111101010100000000000000000000010101111111111111
1000100000001010000000000000000000000000100000000010001
1011101011111010100000000000000000000010101111111010101
1000101010001010100000000000000000000010101000000010101
1010101111101010101111011111111111111011111010101010101
1000100000001010000000000000000000000000001000101010001
1011111111111010111110111011101110111110101111101011101
1010101010101010111110111011101110111110101011111010101
1010101010101010000000000000000000000000101010001010101
1010101010101010111111111011111011111110101010101010101
1000000000000000000000000010000000000000000000000000001
1111111111111111111111111111111111111111111111111111111
